considered - smatra
custom - prilagodjen
attached - privržen
to be able -  biti sposoban za 
whose - cije
slightly - malo
attention - paznja
though - iako
essentially - u sustini
smooth - glatko
despite - bez obzira na
countdown - odbrojavanje
reduced - smanjen
rather - radije
additionally - dodatno
affected - uticao
consider - uzima u obzir
jealous - ljubomoran
assignment - zadatak
assign - dodijeliti
popup - iskociti
appears - cini
intend - namjeravati
vary - varirati
behavior - ponasanje
whatever - sta god/bez obzira
daunt - obeshrabrujuce
comprise - ukljuciti
retrieve - povratiti
 shelf - polica
compared - u odnosu
briefly - kratko
notice - obavijest
disappear - nestati
encountered - naisao
expressed - izraziti
mark - oznaka
among - medju
dedicated - posvecen
separately - odvojeno
reuse - ponovo upotrijebiti
figure out - shvatiti
currently - trenutno
commonly - obicno
prefab - gotove
assets - imovina
character - lik
redraw - precrtati
rendered - donio